1 3 4 5 2 3 5 6 4 4 1 3 4 5 2 3 5 6 4 4
4 1 2 8 5 6 7 1 3 4 2 8 9 0 1 4 5 2 4 7
2 8 9 0 1 4 5 2 4 7 2 2 7 7 8 4 1 2 3 2
4 7 1 8 6 4 3 2 5 6 4 7 1 8 6 4 3 2 5 6
3 4 5 9 7 5 4 1 2 4 2 8 9 0 1 4 5 2 4 7
4 5 6 7 7 3 6 8 2 4 3 1 2 8 5 6 7 1 3 4
2 2 7 7 8 4 1 2 3 2 3 1 2 8 5 6 7 1 3 4
3 1 2 8 5 6 7 1 3 4 3 4 5 9 7 5 4 1 2 4
2 8 9 0 1 4 5 2 4 7 3 1 2 8 5 6 7 1 3 4
2 8 9 0 1 4 5 2 4 7 1 3 4 5 2 3 5 6 4 4
4 7 1 8 6 4 3 2 5 6 2 2 7 7 8 4 1 2 3 2
3 4 5 9 7 5 4 1 2 4 3 4 7 8 1 0 4 2 2 1
4 5 6 7 7 3 6 8 2 4 3 8 0 0 3 2 6 7 3 2
2 2 7 7 8 4 1 2 3 2 6 6 6 3 2 1 7 9 0 1
1 3 4 5 2 3 5 6 4 4 2 3 7 4 6 7 1 1 3 2