1 2 3 6 1 3
3 8 4 3 2 1
5 3 5 6 2 8
2 0 0 2 5 7
9 3 2 1 1 6